446C6AAEA8
53D3BA83EC
503C400055
502BFA8055
5000500015
3AC0502AED
6C50100051
5552EAAC7C
513A96C515
3AAAA93BA9

0,0
9,9
SSSSSEESSSEENEEESSEE